apple=quả táo
banana=quả chuối
cat=con mèo
dog=con chó
elephant=con voi
fish=con cá
grape=quả nho
house=ngôi nhà
ice=đá
jungle=rừng rậm
king=vua
lemon=quả chanh
monkey=con khỉ
night=ban đêm
orange=quả cam
pencil=bút chì
queen=nữ hoàng
river=dòng sông
school=trường học
tiger=con hổ
umbrella=cái ô
village=làng
window=cửa sổ
yellow=màu vàng
zebra=ngựa vằn
book=sách
chair=ghế
desk=bàn làm việc
ear=tai
flower=hoa
garden=vườn
hand=tay
island=đảo
juice=nước ép
kite=diều
lamp=đèn
mountain=núi
neck=cổ
ocean=đại dương
paint=sơn
quiet=yên lặng
road=con đường
sun=mặt trời
tree=cây
under=dưới
violet=màu tím
wall=tường
x-ray=tia X
yarn=sợi chỉ
zoo=vườn thú
bird=con chim
clock=đồng hồ
duck=con vịt
egg=trứng
frog=con ếch
goat=con dê
hat=cái mũ
ink=mực
jacket=áo khoác
key=chìa khóa
lion=sư tử
moon=mặt trăng
net=lưới
owl=con cú
pig=con lợn
queen=nữ hoàng
rose=hoa hồng
snake=con rắn
table=bàn
umbrella=cái ô
violin=đàn vi-ô-lông
whale=cá voi
xylophone=đàn phiến gỗ
yard=sân
zipper=khóa kéo
air=không khí
box=hộp
car=xe ô tô
door=cửa
egg=trứng
flag=cờ
gift=quà tặng
hill=đồi
iron=sắt
joke=trò đùa
kite=diều
lake=hồ
mirror=gương
needle=kim
open=mở
plate=đĩa
queen=nữ hoàng
ring=nhẫn
stone=đá
tooth=răng
uncle=chú
voice=giọng nói
wolf=chó sói
